50,0,1000
500,300
(0)[0][0][0][0][0][0][0][0][0][0][0][0][0][0][0][0][0][0][0][0](0)
(0)[0][0][0][0][0][0][0][0][0][0][0][0][0][0][0][0][0][0][0][0](0)
(0)[0][0][0][0][0][0][0][0][0][0][0][0][0][0][0][0][0][0][0][0](0)
(0)[0][0][0][0][0][0][0][0][0][0][0][0][0][0][0][0][0][0][0][0](0)
(0)[0][0][0][0][0][0][0][0][0][0][0][0][0][0][0][0][0][0][0][0](0)
(0)[0][0][0][0][0][0][0][0][0][0][0][0][0][0][0][0][0][0][0][0](0)
(0)[0][0][0][0][0][0][0][0][0][0][0][0][0][0][0][0][0][0][0][0](0)
(0)[0][0][0][0][0][0][0][0][0][0][0][0][0][0][0][0][0][0][0][0](0)
(0)[0][0][0][0][0][0][0][0][0][0][0][0][0][0][0][0][0][0][0][0](0)
(0)[0][0][0][0][0][0][0][0][0][0][0][0][0][0][0][0][0][0][0][0](0)
(0)[0][0][0][0][0][0][0][0][0][0][0][0][0][0][0][0][0][0][0][0](0)
(0)(0)(0)(0)(0)(0)[0][0][0][0][0][0][0][0][0][0][0][0][0][0][0](0)
(0)[0][0][0][0][0][0][0][0][0][0][0][0][0][0][0][0][0][0][0][0](0)
(0)[0][0][0][0][0][0][0][0][0][0][0][0][0][0][0][0][0][0][0][0](0)
(0)[0][0][0][0][0][0][0][0][0][0][0][0][0][0][0][0][0][0][0][0](0)
(0)[0][0][0][0][0][0][0][0][0][0][0][0][0][0][0][0][0][0][0][0](0)
(0)[0][0][0][0][0][0][0][0][0][0][0][0][0][0][0][0][0][0][0][0](0)
(0)(0)(0)(0)(0)(0)(0)(0)(0)(0)(0)(0)(0)(0)(0)(0)(0)(0)(0)(0)(0)(0)